kudrejo -- szwalnia
akrevida -- sharp-sighted
revi -- marzyć
sopiri -- wzdychać, yearn for
dormanta sur ia mistero -- śpiący na tajemnicy
hontema -- bashful, wstydliwy
ftizo -- tuberculosis
ni enfalas en ftizon -- dostajemy suchot
ŝirmita -- otulona (skrzydłami)
ŝirmitaj de flugiloj de la dio de amo
traflug -- przelatywać
forte pli multaj -- daleko liczniejsze
larmo -- łza
verŝante multe da larmoj -- łzy lejąc obfite
peki -- grzeszyć
kruele pekante -- grzesząc okrutnie
falante en la abismon de honto -- spadając w otchłanie wstydu
morti de malsato -- umrzeć z głodu
kuntuŝiĝi -- adjoin
korto -- dziedziniec, podwórze, court
vasta -- obszerny
masonita -- murowany
sur la perono -- na ganku/peronie (?)
en funebra vesto -- w żałobnej sukni
alkroĉiĝis al ŝiaj manoj -- czepiała się jej rąk
pendi -- zwisać
oportune aranĝita [loĝejo] -- wygodnie urządzone mieszkanie
punca -- pąsowy, flaming red
lano -- wool, wełna
kanapoj kaj brakseĝoj -- kanapy i fotele
tegita -- obity
ŝrankoj kaj komodoj -- szafy i komody
konsolka -- tableto
marmoraj plataĵoj
daturarbo -- datura stramonium
oleandra arbo -- drzewo oleandrowe
branĉoj -- gałęzie

